8
20
0,0
7,19
0000000+0000+0000000
0+00++0000+000++++00
0+0++0+++++++++0+000
000++000000000000000
++++++0+++++++++++++
0000000000++++++++++
+++++00000000000++++
++++++++++++00000000